4995,4996,5004,5007,5002,5000,
N,N,N,b,b,b,b,b,b,c,b,b,
b,c,b,b,b,b,b,b,b,b,b,b,
b,b,c,b,c,e,b,b,c,b,b,c,
b,b,b,b,b,b,b,a,b,b,b,b,
b,b,b,b,b,b,b,a,b,b,b,b,
d,b,b,b,a,a,a,a,b,b,c,b,
d,b,b,b,b,b,b,e,b,b,b,b,
c,b,b,b,c,e,b,c,b,b,b,b,
b,b,b,b,b,b,b,c,c,b,b,b,
b,b,b,b,b,b,b,b,b,d,b,b,
